0,0,0,0,0,0,0,0,0,0,0,0,0,0,0,0,0,0,0,0
0,1,1,1,1,1,1,1,0,0,0,0,0,0,1,1,1,0,0,0
0,1,0,0,0,0,0,1,0,8,0,0,0,0,3,0,1,0,8,0
0,1,0,9,7,0,0,2,0,0,0,0,8,0,1,6,1,0,0,0
0,1,0,0,0,0,0,1,0,0,0,0,0,0,1,1,1,0,0,0
0,1,0,0,0,0,0,1,0,0,0,0,0,0,0,0,0,0,0,0
0,1,1,1,2,1,1,1,0,0,8,0,0,0,0,8,0,0,0,0
0,0,0,0,0,0,0,0,0,0,0,0,0,0,0,0,0,0,0,0
0,0,8,0,0,0,0,0,0,0,0,0,0,0,0,0,5,0,0,0
0,0,0,0,0,0,0,8,0,1,1,1,1,0,0,0,0,0,0,0
0,0,4,9,0,0,0,0,0,1,0,9,1,0,0,0,0,0,8,0
0,0,0,0,0,0,0,0,0,2,0,7,1,0,0,0,0,0,0,0
0,8,0,0,0,0,0,0,0,1,0,0,1,0,1,1,2,1,1,0
0,0,0,0,0,8,0,0,0,1,1,2,1,0,1,0,0,0,1,0
0,0,0,0,0,0,0,0,0,0,0,0,0,0,1,0,0,7,1,0
0,0,0,0,0,0,0,0,0,0,0,8,0,0,1,0,8,0,1,0
0,1,1,1,3,1,1,1,0,0,0,0,0,0,2,0,0,0,1,0
0,1,9,0,0,0,6,1,0,0,6,0,0,0,1,1,1,1,1,0
0,1,1,1,1,1,1,1,0,0,0,0,8,0,0,0,0,0,0,0
0,0,0,0,0,0,0,0,0,0,0,0,0,0,0,0,0,0,0,0
